"aa" = (/turf/indestructible/matrix,/area/djstation)
"ab" = (/turf/simulated/floor/engine/wasteland,/area/djstation)
"ac" = (/turf/simulated/floor/engine/housebase{dir = 4; icon_state = "outerpavement"},/area/djstation)
"ad" = (/obj/structure/ruins{icon_state = "wasteland2"},/turf/simulated/floor/engine/wasteland,/area/djstation)
"ae" = (/turf/simulated/floor/engine/housebase{icon_state = "housewasteland"},/area/djstation)
"af" = (/turf/indestructible/repconn{icon_state = "wasteland3"},/area/djstation)
"ag" = (/turf/simulated/floor/engine/housebase{dir = 8; icon_state = "outerpavement"},/area/djstation)
"ah" = (/turf/simulated/floor/engine/housebase{dir = 2; icon_state = "outerpavementcorner"},/area/djstation)
"ai" = (/turf/simulated/floor/engine/housebase{icon_state = "outerpavement"},/area/djstation)
"aj" = (/turf/simulated/floor/engine/housebase{dir = 6; icon_state = "outerpavement"},/area/djstation)
"ak" = (/obj/structure/ruins{icon_state = "wasteland3bottom"},/turf/simulated/floor/engine/wasteland,/area/djstation)
"al" = (/turf/simulated/floor/engine/housebase{icon_state = "housewood3-broken1"},/area/djstation)
"am" = (/turf/simulated/floor/engine/housebase,/area/djstation)
"an" = (/turf/simulated/floor/engine/housebase{icon_state = "housewood3-broken2"},/area/djstation)
"ao" = (/obj/item/weapon/bikehorn,/turf/simulated/floor/engine/house{icon_state = "housewood1-broken"},/area/djstation)
"ap" = (/turf/simulated/floor/engine/housebase{dir = 10; icon_state = "outerpavement"},/area/djstation)
"aq" = (/turf/simulated/floor/engine/housebase{dir = 8; icon_state = "outerpavementcorner"},/area/djstation)
"ar" = (/obj/structure/flora/grass/wasteland,/turf/simulated/floor/engine/wasteland,/area/djstation)
"as" = (/turf/indestructible/repconn{icon_state = "supermart6"},/area/djstation)
"at" = (/turf/indestructible/repconn{icon_state = "storeprewindowleft"},/area/djstation)
"au" = (/turf/indestructible/robco{icon_state = "storewindowleft"},/area/djstation)
"av" = (/turf/indestructible/robco{icon_state = "storewindowhorizontal"},/area/djstation)
"aw" = (/turf/indestructible/robco{icon_state = "storewindowright"},/area/djstation)
"ax" = (/turf/indestructible/repconn{icon_state = "storeprewindowright"},/area/djstation)
"ay" = (/turf/indestructible/repconn{icon_state = "supermart14"},/area/djstation)
"az" = (/turf/indestructible/repconn{icon_state = "supermart12"},/area/djstation)
"aA" = (/turf/indestructible/repconn{icon_state = "supermart10"},/area/djstation)
"aB" = (/turf/indestructible/repconn{icon_state = "wasteland10"},/area/djstation)
"aC" = (/turf/indestructible/repconn{icon_state = "wasteland12"},/area/djstation)
"aD" = (/obj/effect/decal/decoration,/turf/indestructible/corvega{icon_state = "dirtyglass"; name = "locked room"},/area/djstation)
"aE" = (/turf/indestructible/repconn{icon_state = "supermart3"},/area/djstation)
"aF" = (/obj/structure/closet,/obj/machinery/light{dir = 1},/turf/simulated/floor/engine/vaulttec{icon_state = "floordirty"},/area/djstation)
"aG" = (/turf/simulated/floor/engine/vaulttec{icon_state = "floorrusty"},/area/djstation)
"aH" = (/obj/item/trash/can,/turf/simulated/floor/engine/vaulttec{icon_state = "floorrusty"},/area/djstation)
"aI" = (/turf/indestructible/repconn{icon_state = "supermart1"},/area/djstation)
"aJ" = (/obj/structure/mopbucket,/turf/simulated/floor/engine/vaulttec{icon_state = "bluedirtychess"},/area/djstation)
"aK" = (/obj/machinery/light/small{dir = 1},/obj/item/weapon/mop,/turf/simulated/floor/engine/vaulttec{icon_state = "bluedirtychess"},/area/djstation)
"aL" = (/obj/structure/toilet,/turf/simulated/floor/engine/vaulttec{icon_state = "bluedirtychess"},/area/djstation)
"aM" = (/obj/structure/bookcase/manuals/medical,/turf/simulated/floor/engine/house,/area/djstation)
"aN" = (/obj/structure/table/wood,/obj/structure/mirror{pixel_y = 25},/turf/simulated/floor/engine/house,/area/djstation)
"aO" = (/obj/structure/bookcase/random/nonfiction,/turf/simulated/floor/engine/house,/area/djstation)
"aP" = (/obj/structure/closet/wardrobe/white/medical,/turf/simulated/floor/engine/house,/area/djstation)
"aQ" = (/turf/simulated/floor/engine/house,/area/djstation)
"aR" = (/obj/machinery/light/small{dir = 1},/turf/simulated/floor/engine/house,/area/djstation)
"aS" = (/obj/effect/decal/clock/oldactive{step_y = 30},/turf/simulated/floor/engine/house,/area/djstation)
"aT" = (/turf/simulated/floor/engine/house{icon_state = "housewood3"},/area/djstation)
"aU" = (/obj/structure/table/wood,/turf/simulated/floor/engine/house,/area/djstation)
"aV" = (/turf/indestructible/robco{icon_state = "storewindowtop"},/area/djstation)
"aW" = (/turf/simulated/floor/engine/vaulttec{icon_state = "floordirty"},/area/djstation)
"aX" = (/obj/structure/table,/turf/simulated/floor/engine/vaulttec{icon_state = "floorrusty"},/area/djstation)
"aY" = (/turf/simulated/floor/engine/vaulttec{icon_state = "bluedirtychess"},/area/djstation)
"aZ" = (/obj/item/trash/deadmouse,/turf/simulated/floor/engine/vaulttec{icon_state = "bluedirtychess"},/area/djstation)
"ba" = (/turf/simulated/floor/engine/house{icon_state = "housewood2"},/area/djstation)
"bb" = (/turf/indestructible/robco{icon_state = "storewindowvertical"},/area/djstation)
"bc" = (/obj/structure/table,/obj/item/weapon/reagent_containers/food/drinks/drinkingglass/shotglass,/turf/simulated/floor/engine/vaulttec{icon_state = "floordirty"},/area/djstation)
"bd" = (/obj/structure/table,/obj/item/weapon/lighter/greyscale,/turf/simulated/floor/engine/vaulttec{icon_state = "floorrusty"},/area/djstation)
"be" = (/obj/structure/table,/obj/item/weapon/reagent_containers/food/drinks/drinkingglass/shotglass,/turf/simulated/floor/engine/vaulttec{icon_state = "floorrusty"},/area/djstation)
"bf" = (/turf/indestructible/repconn{icon_state = "supermart2"},/area/djstation)
"bg" = (/obj/structure/table,/obj/item/weapon/light/tube,/turf/simulated/floor/engine/vaulttec{icon_state = "bluedirtychess"},/area/djstation)
"bh" = (/obj/structure/sink{dir = 4; step_x = 15; step_y = 5},/obj/structure/mirror{pixel_x = 30},/turf/simulated/floor/engine/vaulttec{icon_state = "bluedirtychess"},/area/djstation)
"bi" = (/turf/indestructible/repconn{icon_state = "wasteland3alt"},/area/djstation)
"bj" = (/obj/structure/bed/chair/comfy/brown{dir = 4},/turf/simulated/floor/engine/house{icon_state = "housewood2"},/area/djstation)
"bk" = (/turf/simulated/floor/engine/house{icon_state = "housewood1-broken"},/area/djstation)
"bl" = (/obj/structure/bed/chair/wood/worn{dir = 4},/turf/simulated/floor/engine/house,/area/djstation)
"bm" = (/obj/structure/table/wood,/turf/simulated/floor/engine/house{icon_state = "housewood3"},/area/djstation)
"bn" = (/obj/structure/bed/chair/wood/worn{dir = 8},/turf/simulated/floor/engine/house,/area/djstation)
"bo" = (/turf/indestructible/robco{icon_state = "storewindowbottom"},/area/djstation)
"bp" = (/obj/structure/bed/stool/red,/turf/simulated/floor/engine/vaulttec{icon_state = "floorrusty"},/area/djstation)
"bq" = (/obj/structure/bed/stool/red,/turf/simulated/floor/engine/vaulttec{icon_state = "floordirty"},/area/djstation)
"br" = (/turf/indestructible/repconn{icon_state = "supermart7"},/area/djstation)
"bs" = (/turf/indestructible/repconn{icon_state = "supermart11"},/area/djstation)
"bt" = (/obj/structure/table/wood,/turf/simulated/floor/engine/house{icon_state = "housewood2"},/area/djstation)
"bu" = (/turf/simulated/floor/engine/house{icon_state = "housewood2-broken"},/area/djstation)
"bv" = (/obj/structure/bed/chair/wood/worn{dir = 4},/turf/simulated/floor/engine/house{icon_state = "housewood3"},/area/djstation)
"bw" = (/obj/structure/table/wood,/obj/item/trash/candle,/turf/simulated/floor/engine/house,/area/djstation)
"bx" = (/obj/structure/bed/chair/wood/worn{dir = 8},/turf/simulated/floor/engine/house{icon_state = "housewood2"},/area/djstation)
"by" = (/obj/machinery/light{dir = 8},/turf/simulated/floor/engine/vaulttec{icon_state = "floorrusty"},/area/djstation)
"bz" = (/obj/item/weapon/cigbutt,/turf/simulated/floor/engine/vaulttec{icon_state = "floorrusty"},/area/djstation)
"bA" = (/obj/machinery/light{dir = 4},/turf/simulated/floor/engine/vaulttec{icon_state = "floorrusty"},/area/djstation)
"bB" = (/obj/structure/rack,/turf/simulated/floor/engine/vaulttec{icon_state = "floorrusty"},/area/djstation)
"bC" = (/obj/structure/closet/cabinet,/turf/simulated/floor/engine/vaulttec{icon_state = "floordirty"},/area/djstation)
"bD" = (/obj/machinery/light/small,/turf/simulated/floor/engine/house,/area/djstation)
"bE" = (/obj/structure/fence/fencenormal,/turf/simulated/floor/engine/housebase{dir = 8; icon_state = "outerpavement"},/area/djstation)
"bF" = (/obj/structure/fence/fencedoor,/turf/simulated/floor/engine/wasteland,/area/djstation)
"bG" = (/obj/structure/fence/fencenormal,/turf/simulated/floor/engine/housebase{dir = 4; icon_state = "outerpavement"},/area/djstation)
"bH" = (/obj/structure/piano,/turf/simulated/floor/engine/vaulttec{icon_state = "floordirty"},/area/djstation)
"bI" = (/obj/structure/bed/chair/wood/normal{dir = 8},/turf/simulated/floor/engine/vaulttec{icon_state = "floordirty"},/area/djstation)
"bJ" = (/obj/machinery/light/small{dir = 4},/turf/simulated/floor/engine/vaulttec{icon_state = "floordirty"},/area/djstation)
"bK" = (/turf/indestructible/robco{icon_state = "wastelandwindowbroken"},/area/djstation)
"bL" = (/obj/effect/decal/decoration,/turf/indestructible/robco,/area/djstation)
"bM" = (/obj/structure/bed/chair/comfy/brown,/turf/simulated/floor/engine/vaulttec{icon_state = "floorrusty"},/area/djstation)
"bN" = (/obj/item/weapon/broken_bottle,/turf/simulated/floor/engine/vaulttec{icon_state = "floorrusty"},/area/djstation)
"bO" = (/obj/structure/table/wood,/turf/simulated/floor/engine/vaulttec{icon_state = "floorrusty"},/area/djstation)
"bP" = (/obj/structure/table/wood,/obj/item/weapon/book/manual/barman_recipes,/turf/simulated/floor/engine/vaulttec{icon_state = "floorrusty"},/area/djstation)
"bQ" = (/turf/simulated/floor/engine/housebase{dir = 4; icon_state = "outerpavementcorner"},/area/djstation)
"bR" = (/turf/simulated/floor/engine/housebase{dir = 1; icon_state = "outerpavement"},/area/djstation)
"bS" = (/turf/simulated/floor/engine/housebase{dir = 5; icon_state = "outerpavement"},/area/djstation)
"bT" = (/turf/simulated/floor/engine/road,/area/djstation)
"bU" = (/turf/simulated/floor/engine/housebase{dir = 9; icon_state = "outerpavement"},/area/djstation)
"bV" = (/turf/simulated/floor/engine/housebase{dir = 1; icon_state = "outerpavementcorner"},/area/djstation)
"bW" = (/obj/structure/table/wood,/obj/machinery/light{dir = 8},/turf/simulated/floor/engine/vaulttec{icon_state = "floorrusty"},/area/djstation)
"bX" = (/obj/structure/table/wood,/obj/item/weapon/reagent_containers/food/snacks/kebab,/turf/simulated/floor/engine/vaulttec{icon_state = "floordirty"},/area/djstation)
"bY" = (/obj/structure/table/wood,/obj/machinery/light{dir = 4},/turf/simulated/floor/engine/vaulttec{icon_state = "floordirty"},/area/djstation)
"bZ" = (/obj/machinery/light/small{dir = 4},/turf/simulated/floor/engine/vaulttec{icon_state = "floorrusty"},/area/djstation)
"ca" = (/obj/structure/bed/chair/comfy/brown{dir = 1},/turf/simulated/floor/engine/vaulttec{icon_state = "floorrusty"},/area/djstation)
"cb" = (/obj/structure/bed,/obj/item/weapon/bedsheet/red,/turf/simulated/floor/engine/vaulttec{icon_state = "floordirty"},/area/djstation)
"cc" = (/obj/structure/table/wood,/obj/item/device/harmonica,/turf/simulated/floor/engine/vaulttec{icon_state = "floorrusty"},/area/djstation)
"cd" = (/obj/structure/bed,/obj/item/weapon/bedsheet/yellow,/turf/simulated/floor/engine/vaulttec{icon_state = "floordirty"},/area/djstation)
"ce" = (/turf/indestructible/repconn{icon_state = "supermart5"},/area/djstation)
"cf" = (/turf/indestructible/repconn{icon_state = "supermart8"},/area/djstation)
"cg" = (/turf/simulated/floor/engine/vaulttec{icon_state = "floorrustysolid"},/area/djstation)
"ch" = (/turf/indestructible/repconn{icon_state = "supermart4"},/area/djstation)
"ci" = (/turf/indestructible/repconn{icon_state = "supermart13"},/area/djstation)
"cj" = (/turf/simulated/floor/engine/road{icon_state = "horizontaltopbordertop3"},/area/djstation)
"ck" = (/turf/simulated/floor/engine/road{icon_state = "horizontaltopbordertop2"},/area/djstation)
"cl" = (/turf/simulated/floor/engine/road{icon_state = "horizontaltopbordertop1"},/area/djstation)
"cm" = (/turf/simulated/floor/engine/road{icon_state = "horizontaltopbordertop0"},/area/djstation)
"cn" = (/turf/simulated/floor/engine/road{dir = 8; icon_state = "tinycornerhorizontal"},/area/djstation)
"co" = (/obj/machinery/light/small{dir = 4},/turf/simulated/floor/engine/road,/area/djstation)
"cp" = (/obj/machinery/vending/nukacolavend,/turf/simulated/floor/engine/house,/area/djstation)
"cq" = (/obj/effect/decal/sign{desc = "Remove kebab."; icon_state = "vault_kebab"; name = "kebab sign"; pixel_x = -10; pixel_y = 29},/turf/simulated/floor/engine/house,/area/djstation)
"cr" = (/obj/machinery/light/small{dir = 1},/turf/simulated/floor/engine/house{icon_state = "housewood3"},/area/djstation)
"cs" = (/obj/structure/noticeboard{pixel_y = 32},/turf/simulated/floor/engine/house,/area/djstation)
"ct" = (/obj/structure/fireaxecabinet{pixel_y = 30},/turf/simulated/floor/engine/house{icon_state = "housewood2"},/area/djstation)
"cu" = (/obj/structure/filingcabinet/chestdrawer,/turf/simulated/floor/engine/house,/area/djstation)
"cv" = (/turf/simulated/floor/engine/road{icon_state = "horizontaltopborderbottom2"},/area/djstation)
"cw" = (/turf/simulated/floor/engine/road{icon_state = "horizontaltopborderbottom1"},/area/djstation)
"cx" = (/obj/effect/decal/hatch{dir = 1},/turf/simulated/floor/engine/road{icon_state = "horizontaltopborderbottom1"},/area/djstation)
"cy" = (/turf/simulated/floor/engine/road{icon_state = "horizontaltopborderbottom0"},/area/djstation)
"cz" = (/turf/simulated/floor/engine/road{dir = 4; icon_state = "innerturn"},/area/djstation)
"cA" = (/turf/simulated/floor/engine/road{dir = 8; icon_state = "tinycornervertical"},/area/djstation)
"cB" = (/obj/item/weapon/cigbutt,/turf/simulated/floor/engine/housebase{icon_state = "outerpavement"},/area/djstation)
"cC" = (/obj/structure/table/wood,/obj/item/weapon/phone,/turf/simulated/floor/engine/house,/area/djstation)
"cD" = (/turf/simulated/floor/engine/road{icon_state = "horizontalinnermain1"},/area/djstation)
"cE" = (/turf/simulated/floor/engine/road{icon_state = "horizontalinnermain2"},/area/djstation)
"cF" = (/turf/simulated/floor/engine/road{icon_state = "horizontalinnermain0"},/area/djstation)
"cG" = (/turf/simulated/floor/engine/road{icon_state = "verticalrightborderright1"},/area/djstation)
"cH" = (/obj/structure/table/wood,/obj/item/toy/redbutton,/turf/simulated/floor/engine/house,/area/djstation)
"cI" = (/turf/indestructible/corvega,/area/djstation)
"cJ" = (/turf/simulated/floor/engine/road{icon_state = "verticalinnermainbottom"},/area/djstation)
"cK" = (/turf/simulated/floor/engine/road{dir = 8; icon_state = "innermaincornerinner"},/area/djstation)
"cL" = (/turf/simulated/floor/engine/road{icon_state = "hole"},/area/djstation)
"cM" = (/turf/simulated/floor/engine/road{icon_state = "verticalrightborderright0"},/area/djstation)
"cN" = (/obj/effect/decal/cleanable/blood/old,/turf/simulated/floor/engine/road,/area/djstation)
"cO" = (/obj/structure/bed/stool,/turf/simulated/floor/engine/house{icon_state = "housewood2"},/area/djstation)
"cP" = (/turf/simulated/floor/engine/road{dir = 8; icon_state = "innermaincornerouter"},/area/djstation)
"cQ" = (/turf/simulated/floor/engine/road{icon_state = "horizontalinnermainleft"},/area/djstation)
"cR" = (/obj/structure/closet/crate/bin,/turf/simulated/floor/engine/house,/area/djstation)
"cS" = (/obj/structure/table,/obj/item/clothing/head/helmet/f13/eyebot,/turf/simulated/floor/engine/house,/area/djstation)
"cT" = (/turf/simulated/floor/engine/road{dir = 4; icon_state = "innermaincornerinner"},/area/djstation)
"cU" = (/turf/simulated/floor/engine/road{icon_state = "verticalinnermaintop"},/area/djstation)
"cV" = (/turf/simulated/floor/engine/road{dir = 1; icon_state = "innermaincornerinner"},/area/djstation)
"cW" = (/turf/simulated/floor/engine/road{dir = 2; icon_state = "innermaincornerinner"},/area/djstation)
"cX" = (/turf/simulated/floor/engine/vaulttec{icon_state = "floordirtysolid"},/area/djstation)
"cY" = (/turf/indestructible/repconn{icon_state = "storeprewindowtop"},/area/djstation)
"cZ" = (/obj/structure/table/wood,/turf/simulated/floor/engine/vaulttec{icon_state = "floordirty"},/area/djstation)
"da" = (/obj/structure/bookcase/random/reference,/turf/simulated/floor/engine/vaulttec{icon_state = "floorrusty"},/area/djstation)
"db" = (/obj/structure/bookcase/random/nonfiction,/turf/simulated/floor/engine/vaulttec{icon_state = "floorrusty"},/area/djstation)
"dc" = (/obj/structure/rack,/turf/simulated/floor/engine/vaulttec{icon_state = "floordirty"},/area/djstation)
"dd" = (/obj/structure/dresser,/obj/structure/mirror{pixel_y = 25},/turf/simulated/floor/engine/vaulttec{icon_state = "floorrusty"},/area/djstation)
"de" = (/obj/structure/bed,/obj/item/weapon/bedsheet/brown,/turf/simulated/floor/engine/vaulttec{icon_state = "floordirty"},/area/djstation)
"df" = (/obj/structure/table/wood,/obj/item/weapon/reagent_containers/food/drinks/bottle/cognac,/turf/simulated/floor/engine/vaulttec{icon_state = "floordirty"},/area/djstation)
"dg" = (/obj/structure/closet/cabinet,/turf/simulated/floor/engine/vaulttec{icon_state = "floorrusty"},/area/djstation)
"dh" = (/obj/machinery/light{dir = 4},/turf/simulated/floor/engine/vaulttec{icon_state = "floordirty"},/area/djstation)
"di" = (/turf/simulated/floor/engine/road{icon_state = "horizontalbottombordertop1"},/area/djstation)
"dj" = (/turf/simulated/floor/engine/road{icon_state = "horizontalbottombordertop2"},/area/djstation)
"dk" = (/obj/effect/decal/hatch,/turf/simulated/floor/engine/road{icon_state = "horizontalbottombordertop0"},/area/djstation)
"dl" = (/turf/simulated/floor/engine/road{icon_state = "horizontalbottombordertop0"},/area/djstation)
"dm" = (/turf/simulated/floor/engine/road{icon_state = "innerturn"},/area/djstation)
"dn" = (/turf/simulated/floor/engine/road{dir = 1; icon_state = "tinycornervertical"},/area/djstation)
"do" = (/obj/structure/bed/chair/comfy/black,/turf/simulated/floor/engine/vaulttec{icon_state = "floorrusty"},/area/djstation)
"dp" = (/turf/simulated/floor/engine/road{icon_state = "horizontalbottomborderbottom0"},/area/djstation)
"dq" = (/turf/simulated/floor/engine/road{icon_state = "horizontalbottomborderbottom1"},/area/djstation)
"dr" = (/turf/simulated/floor/engine/road{icon_state = "horizontalbottomborderbottom2"},/area/djstation)
"ds" = (/turf/simulated/floor/engine/road{dir = 1; icon_state = "tinycornerhorizontal"},/area/djstation)
"dt" = (/obj/structure/bed/chair/comfy/black{dir = 4},/turf/simulated/floor/engine/vaulttec{icon_state = "floorrusty"},/area/djstation)
"du" = (/obj/structure/table,/obj/item/weapon/lighter/engraved,/turf/simulated/floor/engine/vaulttec{icon_state = "floorrusty"},/area/djstation)
"dv" = (/obj/structure/bed/chair/comfy/black{dir = 8},/turf/simulated/floor/engine/vaulttec{icon_state = "floordirty"},/area/djstation)
"dw" = (/turf/indestructible/repconn{icon_state = "storeprewindowvertical"},/area/djstation)
"dx" = (/obj/structure/table,/obj/item/weapon/coin/silver,/turf/simulated/floor/engine/vaulttec{icon_state = "floorrusty"},/area/djstation)
"dy" = (/obj/structure/bed/chair/comfy/black{dir = 8},/turf/simulated/floor/engine/vaulttec{icon_state = "floorrusty"},/area/djstation)
"dz" = (/obj/structure/bed/chair/wood/worn{dir = 4},/turf/simulated/floor/engine/vaulttec{icon_state = "floordirty"},/area/djstation)
"dA" = (/obj/structure/table,/turf/simulated/floor/engine/vaulttec{icon_state = "floordirty"},/area/djstation)
"dB" = (/obj/structure/bed,/obj/item/weapon/gun/projectile/automatic/pistol,/obj/item/weapon/bedsheet/patriot,/turf/simulated/floor/engine/vaulttec{icon_state = "floorrusty"},/area/djstation)
"dC" = (/obj/structure/bed/chair/comfy/black{dir = 1},/turf/simulated/floor/engine/vaulttec{icon_state = "floorrusty"},/area/djstation)
"dD" = (/obj/structure/table,/obj/structure/bedsheetbin,/turf/simulated/floor/engine/vaulttec{icon_state = "bluedirtychess"},/area/djstation)
"dE" = (/obj/structure/sink{layer = 3.1; step_y = 20},/obj/structure/mirror{layer = 3; pixel_y = 30},/turf/simulated/floor/engine/vaulttec{icon_state = "bluedirtychess"},/area/djstation)
"dF" = (/obj/structure/table,/obj/item/weapon/lipstick,/turf/simulated/floor/engine/vaulttec{icon_state = "bluedirtychess"},/area/djstation)
"dG" = (/turf/simulated/floor/engine/road{dir = 2; icon_state = "outermaincornerouter"},/area/djstation)
"dH" = (/turf/simulated/floor/engine/road{dir = 8; icon_state = "outermaincornerouter"},/area/djstation)
"dI" = (/obj/structure/flora/tree/wasteland,/turf/simulated/floor/engine/wasteland,/area/djstation)
"dJ" = (/obj/structure/table,/obj/item/weapon/switchblade,/turf/simulated/floor/engine/vaulttec{icon_state = "floorrusty"},/area/djstation)
"dK" = (/obj/structure/bed/stool/blue,/turf/simulated/floor/engine/vaulttec{icon_state = "bluedirtychess"},/area/djstation)
"dL" = (/turf/simulated/floor/engine/road{dir = 4; icon_state = "outermaincornerouter"},/area/djstation)
"dM" = (/turf/simulated/floor/engine/road{dir = 1; icon_state = "outermaincornerouter"},/area/djstation)
"dN" = (/turf/indestructible/repconn{icon_state = "storeprewindowbottom"},/area/djstation)
"dO" = (/obj/structure/filingcabinet/filingcabinet,/turf/simulated/floor/engine/vaulttec{icon_state = "floordirty"},/area/djstation)
"dP" = (/obj/structure/bed/chair/office/blue{dir = 1},/turf/simulated/floor/engine/vaulttec{icon_state = "floorrusty"},/area/djstation)
"dQ" = (/obj/machinery/light,/turf/simulated/floor/engine/vaulttec{icon_state = "floorrusty"},/area/djstation)
"dR" = (/obj/machinery/light/small,/turf/simulated/floor/engine/vaulttec{icon_state = "bluedirtychess"},/area/djstation)
"dS" = (/obj/structure/toilet{dir = 8},/turf/simulated/floor/engine/vaulttec{icon_state = "bluedirtychess"},/area/djstation)
"dT" = (/turf/indestructible/repconn{icon_state = "supermart9"},/area/djstation)

(1,1,1) = {"
aaaaaaaaaaaaaaaaaaaaaaaaaaaaaaaaaaaaaaaaaaaaaaaaaaaaaaaaaaaa
aaababacadaeaeaeaeaeafagabababahaiaiaiaiaiaiaiaiaiaiaiaiaiaa
aaahaiajakalamamanaoafapaiaqaracasatauavavavawaxayazazazaAaa
aaacaBaCaBaCaCaDaCaCaBaCaBagabacaEaFaGaHaGaGaGaFaIaJaKaLaEaa
aaacafaMaNaOaPaQaRaSaTaUafagabacaVaGaGaWaGaXaWaWaYaYaYaZaEaa
aaacafaQaTbabaaQaTaQbabaafagabacbbaGbcbdbeaXaGaWbfbgaYbhaEaa
aaacbibjaQbkaQaQbablbmbnbiagabacboaGbpbqbpbpaGaGbrazazazbsaa
aaacafbtbmaTaQaQbubvbwbxafagabacaEbyaGaGaWaWbzbAaIbBbBbCaEaa
aaacafaQaQbDaTaQaQbDaQaQafbEbFbGaEbHbIaGaGaGaWaGaGaWaGbJaEaa
aaacaBaCbKaCaBaQaBaCbLaCaBagabacaEbMbMaWbNaGaGaGbfaGbObPaEaa
aabQbRbRbRbRbSbTbUbRbRbRbRbVabacaEbWbXaWaWaGaGbYaEaGaWbZaEaa
aaababarababacbTagababababababacaEcacaaGaWaGaGcaaEcbcccdaEaa
aaaiaiaiaiaiajbTapaiaiaiaqarabacceazayazcfcgchazciazazazbsaa
aacjckclcmclclcmcmcmcnbTagababacbTcoaEcpcqaQaQcrcsaQctcuaEaa
aacvcwcwcwcvcxcycycyczcAapaicBajbTbTaIaQbaaTaQbkaUcCaQaTaEaa
aacDcEcDcDcDcDcDcFcFcFcGbTbTbTbTbTbTaQaQbababaaTcHbnaQbacIaa
aacJcJcKcFcFcLcDcDcDcFcMbUbRbRbScNbTbfbabubaaQaQaUaUaTcOaEaa
aacPabcQcDcFcDcEcDcDcFcMagababacbTcoaEcRaQaQaQbDaQbabacSaEaa
aacTcUcVcDcDcWcJcKcEcDcMagababacasazciazcfcXchazayazazazbsaa
aacFcDcDcDcEcTcUcVcDcEcGagababaccYcZdadbdcaWaWddaEdedfdgaEaa
aacLcDcDcDcDcDcEcDcDcDcMagababacaVaGaGaWaGaWaGdhaEaGaGbZaEaa
aadicDdjdicDdkdldldldmdnagabaracbbaWaWdodoaGaGaWaIaWaGaWaEaa
aadpdqdrdqdpdpdpdpdpdsbTagababacboaWdtbcdudvaGaGaGaGaGbJaEaa
aabRbRbRbRbRbRbRbRbRbRbRbVababacdwaWdtdxaXdyaGaWbfdzdAdBaEaa
aaababababababababababababababacaVaWaGdCdCaGaWbAbrazazazbsaa
aaabarababababababababababababacbbaWaWaGaWaGaGaGaIdDdEdFaEaa
aaabababdGdHabababababdIabababacbodJdAaXaGaWaGaWaYaYaYdKaEaa
aaabababdLdMabarabababababababacdNdOdPdQaGdQaWaGbfaYdRdSaEaa
aaababababababababababababababacceazazazazazazazciazazazdTaa
aaaaaaaaaaaaaaaaaaaaaaaaaaaaaaaaaaaaaaaaaaaaaaaaaaaaaaaaaaaa
"}
